8 8
S     X 
X   X   
XX X  X 
   X X  
  X   XX
 X   XX 
X   X   
      XD
